11111111111111111111
10000000C00000000001
1P000000000000M00001
10000000C000000000E1
11111111111111111111