11111111111111111111111
1E00M00M00M0000C00M0001
10100100000M00000000M01
1000000010101010M010C01
1P000M000C00C000C0M00C1
11111111111111111111111