11111111111111111111111
1E00M00M00M0000C00M0C01
10100101001M00M01010M01
1010010010101010M010C01
1P000M000C00C000C0M00C1
11111111111111111111111