1111111111111111111111
1E0000000000000C00M001
10100101001M0000101001
1010010010101010001001
1P0000000C00C00000M001
1111111111111111111111